{
    "start": [8,1],
    "end": [8,12],
    "x_btn_list": [],
    "o_btn_list": [],
    "split_btn_list": [],
    "map": [
        [1,1,1,0,0,0,0,0,0,0],
        [1,1,1,1,1,1,0,0,0,0],
        [1,1,1,1,1,1,1,1,1,0],
        [0,1,1,1,1,1,1,1,1,1],
        [0,0,0,0,0,1,1,1,1,1],
        [0,0,0,0,0,0,1,1,1,0]
    ]
}