{
    "start": [1,9],
    "end": [1,1],
    "x_btn_list": [
        [9,11,"toggle",-1,[[2,12],[3,12],[1,6],[1,7]]]
    ],
    "o_btn_list": [
        [9,5,"toggle",-1,[[1,3],[1,4]]]
    ],
    "split_btn_list": [
        [1,12,-1,[[1,12],[1,9]]]
    ],
    "map": [
        [1,1,1,0,0,0,0,0,1,1,1,1,1,1],
        [1,1,1,0,0,1,0,0,1,1,1,1,1,1],
        [1,1,1,0,0,0,0,0,1,1,1,1,0,0],
        [0,0,0,0,0,0,0,0,0,1,1,1,0,0],
        [0,0,0,0,0,0,0,0,0,0,0,1,1,0],
        [0,0,0,0,0,0,0,0,0,0,0,0,1,0],
        [0,0,0,0,0,0,0,0,0,0,0,0,1,0],
        [0,0,0,0,0,0,0,0,0,0,0,1,1,0],
        [0,0,0,0,1,1,1,1,1,0,0,1,1,0],
        [0,0,0,0,1,1,0,0,1,1,1,1,1,0]
    ]
}