{
    "start": [5,0],
    "end": [1,2],
    "x_btn_list": [],
    "o_btn_list": [
        [6,6,"hide",-1,[[0,4],[1,4]]]
    ],
    "split_btn_list": [],
    "map": [
        [0,1,1,1,1,0,0,0,0,0,0,0],
        [0,1,1,1,1,0,0,0,0,0,0,0],
        [0,1,1,1,0,0,0,0,0,0,0,0],
        [0,1,0,0,0,1,1,1,1,1,1,0],
        [0,1,0,0,0,1,1,0,0,1,1,0],
        [1,1,1,1,1,1,1,0,0,1,1,1],
        [0,0,0,0,0,1,1,0,0,0,0,1],
        [0,0,0,0,0,1,1,1,1,0,0,1],
        [0,0,0,0,0,1,1,1,1,1,1,1],
        [0,0,0,0,0,0,0,0,1,1,1,0]
    ]
}