{
    "start": [6,2],
    "end": [4,4],
    "x_btn_list": [
        [2,6,"toggle",-1,[[2,12]]],
        [0,12,"toggle",-1,[[4,6]]]
    ],
    "o_btn_list": [],
    "split_btn_list": [],
    "map": [
        [0,0,0,0,0,0,0,0,0,0,0,0,1],
        [0,0,0,0,0,1,1,1,0,0,1,1,1],
        [0,0,0,0,0,1,1,1,1,1,1,1,0],
        [0,0,0,1,1,1,1,1,0,0,1,1,0],
        [0,0,0,1,1,1,0,0,0,0,1,1,0],
        [0,1,1,1,1,1,0,0,0,1,1,1,1],
        [1,1,1,1,0,0,0,0,0,1,1,1,1],
        [1,1,1,1,0,0,1,1,1,1,1,0,0],
        [0,0,0,0,0,1,1,1,0,0,0,0,0],
        [0,0,0,0,0,1,1,1,0,0,0,0,0]
    ]
}