{
    "start": [3,12],
    "end": [4,7],
    "x_btn_list": [],
    "o_btn_list": [],
    "split_btn_list": [],
    "map": [
        [1,1,1,2,1,1,1,1,2,1,1,1,1,0],
        [1,1,0,0,0,0,0,0,0,0,1,1,1,0],
        [1,1,0,0,0,0,0,0,0,0,0,1,1,1],
        [1,1,1,0,0,0,1,1,1,0,0,1,1,1],
        [1,1,1,2,2,2,1,1,1,0,0,1,1,1],
        [1,1,1,0,0,2,1,1,1,0,0,1,0,0],
        [0,0,1,0,0,2,2,2,2,2,1,1,0,0],
        [0,0,1,1,1,2,2,1,2,2,2,0,0,0],
        [0,0,0,1,1,2,2,2,2,2,2,0,0,0],
        [0,0,0,1,1,1,0,0,1,1,0,0,0,0]
    ]
}