{
    "start": [2,4],
    "end": [8,3],
    "x_btn_list": [
        [9,13,[[3,1,"toggle"],[3,2,"toggle"]]],
        [3,12,[[2,1,"toggle"],[2,2,"toggle"]]]
    ],
    "o_btn_list": [],
    "split_btn_list": [],
    "map": [
        [0,0,0,0,0,0,0,0,1,1,1,0,0,0],
        [0,0,0,1,1,1,0,0,1,1,1,0,0,0],
        [1,0,0,1,1,1,1,1,1,1,1,1,1,1],
        [1,0,0,1,1,1,0,0,0,0,0,0,1,1],
        [1,0,0,0,0,0,0,0,0,0,0,0,1,1],
        [1,0,0,0,0,0,0,0,0,0,0,0,1,1],
        [1,0,0,0,0,0,0,0,1,1,1,1,1,1],
        [1,1,1,1,1,0,0,0,1,1,1,0,0,0],
        [0,1,1,1,1,0,0,0,1,1,1,0,0,0],
        [0,0,1,1,1,0,0,0,1,1,1,1,1,1]
    ]
}