{
  "start": [8, 1],
  "end": [8, 12],
  "x_btn_list": [[1,12,[[2,2,"unhide"],[2,3,"unhide"],[1,5,"unhide"],[1,6,"unhide"]]]],
  "o_btn_list": [ 
    [3,8,[[1,5,"hide"],[1,6,"hide"],[1,10,"unhide"],[1,11,"unhide"]]],
    [9,11,[[8,9,"hide"],[8,10,"hide"]]],
    [7,11,[[8,9,"hide"],[8,10,"hide"]]]
    ],
  "split_btn_list": [[5,7,[[8,1],[1,13]]]],
  "map": [
    [0, 0, 0, 0, 0, 0, 0, 1, 1, 1, 0, 0, 1, 1, 1],
    [0, 0, 0, 0, 1, 1, 1, 1, 1, 1, 0, 0, 1, 1, 1],
    [1, 1, 0, 0, 1, 0, 0, 1, 1, 1, 0, 0, 1, 1, 1],
    [1, 1, 1, 1, 1, 0, 0, 0, 1, 0, 0, 0, 0, 0, 0],
    [1, 1, 0, 0, 0, 0, 0, 0, 0, 0, 0, 0, 0, 0, 0],
    [0, 1, 0, 0, 0, 0, 0, 1, 0, 0, 0, 0, 0, 0, 0],
    [0, 1, 0, 0, 0, 0, 0, 1, 0, 0, 0, 0, 0, 0, 0],
    [1, 1, 1, 0, 0, 0, 1, 1, 1, 0, 0, 1, 1, 1, 0],
    [1, 1, 1, 1, 1, 1, 1, 1, 1, 1, 1, 1, 1, 1, 0],
    [1, 1, 1, 0, 0, 0, 1, 1, 1, 0, 0, 1, 1, 1, 0]
  ]
}
