{
    "start": [1,1],
    "end": [2,13],
    "x_btn_list": [
        [6,12,[[2,7,"unhide"]]],
        [3,13,[[6,6,"unhide"]]],
        [9,12,[[1,9,"unhide"],[7,8,"hide"]]],
        [3,12,[[6,6,"hide"]]]
    ],
    "o_btn_list": [
        [8,1,[[7,8,"toggle"]]]
    ],
    "split_btn_list": [],
    "map": [
        [1,1,1,0,0,0,0,0,0,0,0,0,0,0,0],
        [1,1,1,1,1,1,1,1,1,0,0,0,1,1,1],
        [1,1,1,0,0,0,0,0,1,1,1,1,1,1,1],
        [1,1,1,0,0,0,0,0,0,0,0,0,1,1,1],
        [1,1,1,0,0,0,0,0,0,0,0,0,0,0,0],
        [1,1,1,0,0,0,0,0,0,0,0,0,0,0,0],
        [1,1,1,0,0,0,0,1,1,1,1,1,1,0,0],
        [1,1,1,1,1,1,1,1,0,0,0,1,1,0,0],
        [1,1,1,0,0,0,0,0,0,0,0,1,1,0,0],
        [1,1,1,0,0,0,0,0,0,0,0,1,1,0,0]
    ]
}