{
    "start": [0,1],
    "end": [7,12],
    "x_btn_list": [
    ],
    "o_btn_list": [
        [0,10,[[5,8,"toggle"],[5,7,"toggle"]]],
        [5,10,[[10,3,"hide"],[10,2,"hide"]]],
        [9,10,[[10,3,"unhide"],[10,2,"unhide"]]]
    ],
    "split_btn_list": [
    ],
    "map": [
        [0,1,1,1,1,1,1,1,1,1,1,1,1,1,1],
        [0,0,0,0,0,0,1,1,0,0,0,0,0,1,1],
        [0,0,0,0,0,0,1,1,0,0,0,0,0,1,1],
        [0,0,0,0,0,0,0,0,0,0,0,0,0,1,1],
        [0,0,0,0,0,0,0,0,0,0,0,0,0,1,1],
        [1,1,1,0,0,1,1,0,0,1,1,1,1,1,1],
        [1,0,1,0,0,1,1,0,0,0,0,0,0,0,0],
        [1,1,1,0,0,1,1,0,0,0,0,0,0,0,0],
        [0,1,1,0,0,1,1,0,0,0,0,0,0,0,0],
        [0,1,1,1,1,1,1,1,1,1,1,1,1,1,0]
    ]
}