{
    "start": [2,8],
    "end": [8,13],
    "x_btn_list": [],
    "o_btn_list": [
        [7,1,[[1,10,"toggle"],[1,11,"toggle"]]],
        [6,12,[[6,11,"toggle"],[6,10,"toggle"]]],
        [4,3,[[1,5,"hide"],[1,6,"hide"]]],
        [4,9,[[1,5,"hide"],[1,6,"hide"]]],
        [2,7,[[1,5,"hide"],[1,6,"hide"]]]
    ],
    "split_btn_list": [
        [4,7,[[1,13],[7,13]]]
    ],
    "map": [
        [0,0,0,0,0,0,0,0,0,0,0,0,1,1,1],
        [0,0,1,1,1,1,1,1,1,1,0,0,1,1,1],
        [0,0,1,1,1,0,0,1,1,1,0,0,1,1,1],
        [0,0,1,1,1,0,0,1,1,1,0,0,0,0,0],
        [0,0,1,1,1,0,0,1,1,1,0,0,0,0,0],
        [0,0,1,1,1,0,0,1,1,1,0,0,0,0,0],
        [1,1,1,1,0,0,0,1,1,1,0,0,1,1,1],
        [1,1,0,0,0,0,0,0,0,0,0,0,1,1,1],
        [0,0,0,0,0,0,0,0,0,0,0,0,1,1,1],
        [0,0,0,0,0,0,0,0,0,0,0,0,1,1,1]
    ]
}