{
    "start": [3,1],
    "end": [5,13],
    "x_btn_list": [
        [5,8,[[9,3,"toggle"]]],
        [6,8,[[7,5,"toggle"]]]
    ],
    "o_btn_list": [],
    "split_btn_list": [],
    "map": [
        [0,0,0,0,0,0,0,0,1,1,0,0,0,0,0],
        [0,0,0,0,0,0,0,1,1,1,0,0,0,0,0],
        [1,1,0,0,1,1,1,1,1,1,0,0,0,0,0],
        [1,1,1,1,1,1,0,0,1,0,0,0,0,0,0],
        [1,1,1,1,0,0,0,0,1,0,0,0,1,1,1],
        [0,1,1,0,0,0,0,0,1,1,1,1,1,1,1],
        [0,0,1,0,0,0,0,0,1,1,0,0,1,1,1],
        [0,0,1,1,1,0,0,0,1,1,0,0,0,0,0],
        [0,0,0,1,1,1,0,0,1,1,0,0,0,0,0],
        [0,0,0,0,1,1,1,1,1,1,0,0,0,0,0]
    ]
}
