{
  "start": [3, 1],
  "end": [1, 12],
  "x_btn_list": [
    [9, 9, [[7, 2, "unhide"]]],
    [9, 2, [[3, 12, "unhide"]]]
  ],
  "o_btn_list": [
    [2, 6, [[7, 2, "hide"],[3, 12, "hide"]]],
    [3, 4, [[7, 2, "hide"],[3, 12, "hide"]]]
  ],
  "split_btn_list": [],
  "map": [
    [0, 0, 0, 0, 0, 1, 1, 0, 0, 0, 0, 1, 1, 1],
    [0, 0, 0, 1, 1, 1, 1, 1, 1, 0, 0, 1, 0, 1],
    [1, 1, 1, 1, 1, 1, 1, 1, 1, 1, 1, 1, 1, 1],
    [1, 1, 1, 1, 1, 0, 0, 1, 1, 1, 1, 1, 0, 0],
    [1, 1, 1, 0, 0, 0, 0, 0, 0, 1, 1, 1, 0, 0],
    [0, 1, 0, 0, 0, 0, 0, 0, 0, 0, 1, 0, 0, 0],
    [0, 1, 0, 0, 0, 0, 0, 0, 0, 0, 1, 0, 0, 0],
    [0, 1, 0, 0, 0, 0, 0, 0, 0, 1, 1, 0, 0, 0],
    [0, 1, 1, 0, 0, 0, 0, 0, 0, 1, 1, 0, 0, 0],
    [0, 0, 1, 0, 0, 0, 0, 0, 0, 1, 0, 0, 0, 0]
  ]
}
