{
    "start": [3, 1],
    "end": [5, 13],
    "x_btn_list": [
      [1, 2, [[3, 4,"unhide"]]]
    ],
    "o_btn_list": [
        [1, 13,[[5, 1,"unhide"],[5, 2,"unhide"],[9,8,"toggle"]]],
        [3, 14, [[2, 10,"hide"],[2, 11,"hide"],[3,14,"hide"]]],  
        [5, 0, [[6, 1,"hide"],[6, 2,"hide"],[3,0,"unhide"]]]
    ],
    "split_btn_list": [
        [7,12,-1,[[7,12],[2,2]]]
    ],
    "map": [
      [0, 1, 1, 1, 0, 0, 0, 0, 0, 0, 0, 0, 1, 1, 1],
      [0, 1, 1, 1, 0, 0, 0, 0, 0, 0, 0, 0, 1, 1, 1],
      [0, 1, 1, 1, 0, 0, 0, 1, 1, 1, 1, 1, 1, 1, 1],
      [0, 1, 1, 1, 0, 0, 0, 1, 0, 1, 0, 0, 1, 1, 1],
      [1, 0, 0, 0, 1, 0, 0, 1, 1, 1, 0, 0, 0, 0, 1],
      [1, 0, 0, 0, 1, 0, 0, 2, 2, 2, 0, 0, 0, 0, 1],
      [1, 0, 0, 1, 1, 1, 2, 2, 2, 2, 2, 1, 1, 1, 1],
      [0, 0, 0, 1, 1, 1, 2, 2, 2, 2, 2, 1, 1, 1, 0],
      [0, 0, 0, 1, 1, 1, 2, 2, 2, 2, 2, 1, 1, 1, 0],
      [0, 0, 0, 1, 1, 1, 1, 1, 0, 0, 0, 0, 0, 0, 0]
    ]
  }
  