{
    "start": [2, 1],
    "end": [6, 11],
    "x_btn_list": [
      [1, 11, [[2, 2,"unhide"],[2, 3,"unhide"]]],
      [3, 0, [[1, 3,"unhide"]]],
      [2, 5, [[7, 7,"unhide"]]],
      [7, 5, [[6, 8,"unhide"],[6, 9,"unhide"]]]
    ],
    "o_btn_list": [
    ],
    "split_btn_list": [
        [1,13,-1,[[6,5],[6,7]]]
    ],
    "map": [
      [0, 0, 0, 0, 0, 0, 0, 0, 0, 0, 1, 1, 1, 1],
      [0, 0, 0, 0, 1, 1, 1, 1, 1, 1, 1, 1, 1, 1],
      [0, 1, 0, 0, 1, 1, 1, 0, 0, 0, 1, 1, 1, 1],
      [1, 1, 0, 0, 1, 1, 0, 0, 0, 0, 0, 0, 1, 0],
      [1, 1, 0, 0, 1, 0, 0, 0, 0, 0, 0, 0, 1, 0],
      [1, 1, 1, 1, 1, 0, 0, 0, 0, 0, 1, 1, 1, 0],
      [1, 1, 1, 0, 0, 1, 1, 1, 0, 0, 1, 0, 1, 0],
      [0, 0, 0, 0, 0, 1, 1, 0, 0, 0, 1, 1, 1, 0]
    ]
  }
  