{
    "start": [5, 10],
    "end": [7, 7],
    "x_btn_list": [
      [7, 1, [[4, 3,"unhide"],[7, 9,"unhide"]]]
    ],
    "o_btn_list": [
        [1, 6, [[4, 3,"unhide"],[7, 9,"unhide"]]]
    ],
    "split_btn_list": [
        [0,13,-1,[[3,2],[3,3]]] 
    ],
    "map": [
      [0, 0, 0, 0, 0, 1, 1, 1, 1, 0, 0, 0, 0, 1],
      [0, 0, 0, 0, 0, 1, 1, 1, 1, 1, 1, 0, 0, 1],
      [0, 0, 0, 0, 1, 1, 1, 1, 1, 1, 1, 0, 0, 1],
      [1, 1, 1, 1, 1, 1, 1, 1, 0, 0, 1, 1, 1, 1],
      [1, 1, 1, 0, 0, 0, 1, 0, 0, 0, 1, 1, 0, 0],
      [1, 1, 1, 0, 0, 0, 1, 0, 0, 0, 1, 0, 0, 0],
      [0, 1, 0, 0, 0, 0, 1, 1, 1, 0, 0, 0, 0, 0],
      [0, 1, 0, 0, 0, 0, 1, 0, 1, 0, 0, 0, 0, 0],
      [0, 0, 0, 0, 0, 0, 1, 1, 1, 0, 0, 0, 0, 0]
    ]
  }
  