{
  "start": [1, 1],
  "end": [6, 1],
  "x_btn_list": [[3, 13, [[9, 9, "hide"], [9, 6, "hide"]]]],
  "o_btn_list": [
    [5, 12, [[9, 6, "hide"]]],
    [5, 13, [[9, 9, "hide"]]]
  ],
  "split_btn_list": [],
  "map": [
    [1, 1, 1, 0, 0, 0, 0, 1, 1, 1, 1, 1, 1, 1, 1],
    [1, 1, 1, 1, 1, 1, 1, 1, 1, 1, 1, 0, 0, 1, 1],
    [1, 1, 1, 0, 0, 0, 0, 1, 1, 0, 0, 0, 0, 1, 1],
    [0, 0, 0, 0, 0, 0, 0, 0, 0, 0, 0, 0, 1, 1, 1],
    [0, 0, 0, 0, 0, 0, 0, 0, 0, 0, 0, 0, 1, 1, 0],
    [1, 1, 1, 0, 0, 2, 2, 2, 2, 1, 0, 0, 1, 1, 0],
    [1, 0, 1, 2, 2, 2, 2, 2, 2, 2, 0, 0, 1, 1, 1],
    [1, 1, 1, 2, 2, 2, 2, 2, 2, 2, 2, 2, 1, 1, 1],
    [0, 0, 0, 2, 2, 2, 2, 2, 2, 2, 2, 2, 1, 1, 1],
    [0, 0, 0, 0, 0, 0, 1, 1, 1, 1, 0, 0, 0, 0, 0]
  ]
}
