{
    "start": [2,2],
    "end": [6,2],
    "x_btn_list": [],
    "o_btn_list": [
        [7,11,[[0,3,"hide"],[0,4,"hide"],[9,8,"hide"],[9,9,"hide"]]]
    ],
    "split_btn_list": [
        [5,11,[[6,14],[9,12]]] 
    ],
    "map": [
        [0,1,1,1,1,1,1,0,0,0,0,0,0,0,0],
        [0,1,1,0,0,1,1,1,0,0,0,0,0,0,0],
        [2,2,1,0,0,1,1,1,1,0,0,0,0,0,0],
        [2,2,0,0,0,0,0,1,1,1,0,0,0,0,0],
        [2,2,0,0,0,0,0,0,1,1,1,0,0,0,0],
        [2,1,1,1,0,0,0,0,0,1,1,1,0,0,0],
        [0,1,1,1,0,0,0,0,0,0,1,1,1,1,1],
        [0,1,1,1,1,1,1,0,0,0,1,1,1,1,1],
        [0,0,1,0,0,1,1,0,0,0,1,1,1,0,0],
        [0,0,1,0,0,1,1,1,1,1,1,1,1,0,0]
    ]
  }
  