{
    "start": [6, 10],
    "end": [3, 2],
    "x_btn_list": [
        [2, 11, [[8, 2, "toggle"], [8, 3, "toggle"]]],
        [0,13 , [[1, 5, "toggle"], [1, 4, "toggle"],[7, 3, "toggle"], [7, 2, "toggle"]]],
        [7, 5, [[2, 4, "toggle"], [2, 5, "toggle"]]]],
    "o_btn_list": [

    ],
    "split_btn_list": [],
    "map": [
      [0, 0, 0, 0, 0, 0, 0, 0, 0, 0, 0, 0, 1, 1],
      [0, 0, 1, 1, 1, 1, 1, 1, 0, 0, 0, 1, 1, 1],
      [0, 1, 1, 1, 0, 0, 1, 1, 0, 0, 1, 1, 1, 1],
      [0, 1, 1, 1, 0, 0, 0, 1, 1, 1, 1, 1, 0, 0],
      [0, 1, 1, 1, 0, 0, 0, 0, 1, 1, 1, 0, 0, 0],
      [0, 0, 0, 0, 0, 0, 0, 0, 0, 1, 1, 0, 0, 0],
      [0, 0, 0, 0, 1, 1, 1, 0, 0, 1, 1, 0, 0, 0],
      [1, 1, 0, 0, 1, 1, 1, 0, 0, 1, 1, 0, 0, 0],
      [1, 1, 0, 0, 1, 1, 1, 1, 1, 1, 1, 0, 0, 0]
    ]
  }
  