{
    "start": [5,1],
    "end": [7,6],
    "x_btn_list": [],
    "o_btn_list": [],
    "split_btn_list": [],
    "map": [
        [0,0,0,2,2,2,2,2,2,2,0,0,0,0],
        [0,0,0,2,2,2,2,2,2,2,0,0,0,0],
        [1,1,1,1,0,0,0,0,0,1,1,1,0,0],
        [1,1,1,0,0,0,0,0,0,0,1,1,0,0],
        [1,1,1,0,0,0,0,0,0,0,1,1,0,0],
        [1,1,1,0,0,1,1,1,1,2,2,2,2,2],
        [1,1,1,0,0,1,1,1,1,2,2,2,2,2],
        [0,0,0,0,0,1,1,1,0,0,2,2,1,2],
        [0,0,0,0,0,1,1,1,0,0,2,2,2,2]
    ]
}