{
    "start": [1,13],
    "end": [8,1],
    "x_btn_list": [],
    "o_btn_list": [
        [1,8,"toggle",-1,[[1,5],[1,6]]],
        [3,3,"unhide",-1,[[8,5],[8,6]]],
        [5,6,"hide",-1,[[8,5],[8,6]]],
        [6,14,"toggle",-1,[[8,5],[8,6]]]
    ],
    "split_btn_list": [],
    "map": [
        [0,0,0,0,0,0,0,0,0,0,0,1,1,1,1],
        [0,1,1,1,1,1,1,1,1,1,1,1,1,1,1],
        [0,1,1,1,1,0,0,0,0,0,0,0,1,1,1],
        [0,1,1,1,1,0,0,0,0,0,0,0,0,0,0],
        [0,1,1,1,1,0,0,0,0,0,0,0,0,0,0],
        [0,0,0,1,1,1,1,1,1,1,1,1,1,0,0],
        [0,0,0,0,0,0,0,0,0,0,1,1,1,1,1],
        [1,1,1,0,0,0,0,0,0,0,1,1,1,1,1],
        [1,1,1,1,1,1,1,1,1,1,1,1,1,0,0],
        [1,1,1,1,0,0,0,0,0,0,0,0,0,0,0]
    ]
}