{
    "start": [3,0],
    "end": [4,13],
    "x_btn_list": [],
    "o_btn_list": [],
    "split_btn_list": [],
    "map": [
        [0,0,0,0,0,1,1,1,1,1,1,0,0,0,0],
        [0,0,0,0,0,1,0,0,1,1,1,0,0,0,0],
        [0,0,0,0,0,1,0,0,1,1,1,1,1,0,0],
        [1,1,1,1,1,1,0,0,0,0,0,1,1,1,1],
        [0,0,0,0,1,1,1,0,0,0,0,1,1,1,1],
        [0,0,0,0,1,1,1,0,0,0,0,0,1,1,1],
        [0,0,0,0,0,0,1,0,0,1,1,0,0,0,0],
        [0,0,0,0,0,0,1,1,1,1,1,0,0,0,0],
        [0,0,0,0,0,0,1,1,1,1,1,0,0,0,0],
        [0,0,0,0,0,0,0,1,1,1,0,0,0,0,0]
    ]
}