{
    "start": [3,1],
    "end": [3,13],
    "x_btn_list": [
        [4,9,"toggle",-1,[[6,3]]]
    ],
    "o_btn_list": [],
    "split_btn_list": [],
    "map": [
        [0,0,0,0,0,0,0,0,1,1,1,1,0,0,0],
        [0,0,0,0,0,0,0,0,1,1,1,1,0,0,0],
        [1,1,1,0,0,0,0,0,1,0,0,1,1,1,1],
        [1,1,1,1,1,1,1,1,1,0,0,0,1,1,1],
        [1,1,1,0,0,0,0,1,1,1,0,0,1,1,1],
        [1,1,1,0,0,0,0,1,1,1,0,0,1,1,1],
        [0,1,1,0,0,0,0,1,0,0,0,0,0,0,0],
        [0,0,1,1,1,1,1,1,0,0,0,0,0,0,0]
    ]
}