{
    "start": [1,1],
    "end": [3,7],
    "x_btn_list": [],
    "o_btn_list": [],
    "split_btn_list": [
        [1,13,[[1,2],[1,12]]]
    ],
    "map": [
        [1,1,1,1,0,0,0,1,0,0,0,1,1,1,1],
        [1,1,1,1,0,0,0,1,0,0,0,1,1,1,1],
        [1,1,1,1,1,1,1,1,1,1,1,1,1,1,1],
        [0,0,0,0,0,0,1,1,1,0,0,0,0,0,0],
        [0,0,0,0,0,0,1,1,1,0,0,0,0,0,0]
    ]
}